UTF8
de :: de :: de
name :: List of German irregular verbs.
dicts_num :: 1
keys :: 0 :: 1 :: 2
eoh

# ÜäöüÄßÖ

backen :: buk :: gebacken
befehlen :: befahl :: befohlen
befleißen :: befliß :: beflissen
beginnen :: begann :: begonnen
beißen :: biß :: gebissen
bergen :: barg :: geborgen
bersten :: barst :: geborsten
bewegen :: bewog :: bewogen
biegen :: bog :: gebogen
bieten :: bot :: geboten
binden :: band :: gebunden
bitten :: bat :: gebeten
blasen :: blies :: geblasen
bleiben :: blieb :: geblieben
braten :: briet :: gebraten
brechen :: brach :: gebrochen
brennen :: brannte :: gebrannt
bringen :: brachte :: gebracht
denken :: dachte :: gedacht
dingen :: dingte :: gedungen
dingen :: dang (obs.) :: gedingt (obs.)
dreschen :: drosch :: gedroschen
dringen :: drang :: gedrungen
dünken :: dünkte :: gedünkt
dürfen :: dürfte :: gedurft
empfehlen :: empfahl :: empfohlen
erlöschen :: erlosch :: erloschen
erkennen :: erkannte :: erkannt
erschrecken :: erschrack :: erschrocken
essen :: aß :: gegessen
fahren :: fuhr :: gefahren
fallen :: fiel :: gefallen
fangen :: fing :: gefangen
fechten :: focht :: gefochten
finden :: fand :: gefunden
flechten :: flocht :: geflochten
fliegen :: flog :: geflogen
fliehen :: floh :: geflohen
fließen :: floss :: geflossen
fressen :: fraß :: gefressen
frieren :: fror :: gefroren
gären :: gor :: gegoren
gebären :: gebar :: geboren
geben :: gab :: gegeben
gedeihen :: gedieh :: gediehen
gehen :: ging :: gegangen
gelingen :: gelang :: gelungen
gelten :: galt :: gegolten
genesen :: genas :: genesen
genießen :: genoß :: genossen
geschehen :: geschah :: geschehen
gewinnen :: gewann :: gewonnen
gießen :: goß :: gegossen
gleichen :: glich :: geglichen
gleiten :: glitt :: geglitten
glimmen :: glomm :: geglommen
graben :: grub :: gegraben
greifen :: griff :: gegriffen
haben :: hatte :: gehabt
halten :: hielt :: gehalten
hängen :: hing :: gehangen
hauen :: haute :: gehauen
hauen :: hieb :: gehauen
heben :: hob :: gehoben
heißen :: hieß :: geheißen
helfen :: half :: geholfen
kennen :: kannte :: gekannt
klimmen :: klomm :: geklommen
klingen :: klang :: geklungen
kneifen :: kniff :: gekniffen
kommen :: kam :: gekommen
können :: konnte :: gekonnt
kriechen :: kroch :: gekrochen
küren :: kürte :: gekürt
laden :: lud :: geladen
lassen :: ließ :: gelassen
laufen :: lief :: gelaufen
leiden :: litt :: gelitten
leihen :: lieh :: geliehen
lesen :: las :: gelesen
liegen :: lag :: gelegen
lügen :: log :: gelogen
mahlen :: mahlte :: gemahlen
meiden :: mied :: gemieden
melken :: melkte :: gemolken
melken :: molk :: gemolken
messen :: maß :: gemessen
mißlingen :: mißlang :: mißlungen
mögen :: mochte :: gemocht
müssen :: musste :: gemußt
nehmen :: nahm :: genommen
nennen :: nannte :: genannt
pfeifen :: pfiff :: gepfiffen
preisen :: pries :: gepriesen
quellen :: quoll :: gequollen
raten :: riet :: geraten
reiben :: rieb :: gerieben
reißen :: riß :: regissen
reiten :: ritt :: geritten
rennen :: rannte :: gerannt
riechen :: roch :: gerochen
ringen :: rang :: gerungen
rinnen :: rann :: geronnen
rufen :: rief :: gerufen
salzen :: salzte :: gesalzen
saufen :: soff :: gesoffen
saugen :: saugte :: gesaugt
saugen :: sog :: gesogen
schaffen :: schuf :: geschaffen
scheiden :: schied :: geschieden
scheinen :: schien :: geschienen
scheißen :: schiß :: geschissen
schelten :: schalt :: gescholten
scheren :: schor :: geschoren
schieben :: schob :: geschoben
schießen :: schoß :: geschossen
schinden :: schund :: geschunden
schlafen :: schlief :: geschlafen
schlagen :: schlug :: geschlagen
schleichen :: schlich :: geschlichen
schleifen :: schliff :: geschliffen
schleißen :: schliß :: geschlissen
schleißen :: schleißte :: geschleißt
schließen :: schloß :: geschlossen
schlingen :: schlang :: geschlungen
schmeißen :: schmiß :: geschmissen
schmelzen :: schmolz :: geschmolzen
schneiden :: schnitt :: geschnitten
schreiben :: schrieb :: geschrieben
schreien :: schrie :: geschrien
schreien :: schrie :: geschrieen
schreiten :: schritt :: geschritten
schweigen :: schwieg :: geschwiegen
schwellen :: schwoll :: geschwollen
schwimmen :: schwamm :: geschwommen
schwinden :: schwand :: geschwunden
schwingen :: schwang :: geschwungen
schwören :: schwor :: geschworen
sehen :: sah :: gesehen
sein :: war :: gewesen
senden :: sandte :: gesandt
sieden :: sott :: gesotten
singen :: sang :: gesungen
sinken :: sank :: gesunken
sinnen :: sann :: gesonnen
sitzen :: saß :: gesessen
sollen :: sollte :: gesollt
speien :: spie :: gespien
speien :: spie :: gespieen
spinnen :: spann :: gesponnen
spleißen :: spliß :: gesplissen
sprechen :: sprach :: gesprochen
sprießen :: sproß :: gesprossen
springen :: sprang :: gesprungen
stechen :: stach :: gestochen
stehen :: stand :: gestanden
stehlen :: stahl :: gestohlen
steigen :: stieg :: gestiegen
sterben :: starb :: gestorben
stieben :: stob :: gestoben
stinken :: stank :: gestunken
stoßen :: stieß :: gestoßen
streichen :: strich :: gestrichen
streiten :: stritt :: gestritten
tragen :: trug :: getragen
treffen :: traf :: getroffen
treiben :: trieb :: getrieben
treten :: trat :: getreten
trinken :: trank :: getrunken
trügen :: trog :: getrogen
tun :: tat :: getan
verderben :: verdarb :: verdorben
verlieren :: verlor :: verloren
wachsen :: wuchs :: gewachsen
wägen :: wog :: gewogen
waschen :: wusch :: gewaschen
weben :: wob :: gewoben
weichen :: wich :: gewichen
weisen :: wies :: gewiesen
wenden :: wandte :: gewandt
werben :: warb :: geworben
werden :: wurde :: geworden (worden)
werfen :: warf :: geworfen
wiegen :: wog :: gewogen
winden :: wand :: gewunden
wissen :: wußte :: gewußt
wollen :: wollte :: gewollt
wringen :: wrang :: gewrungen
zeihen :: zieh :: geziehen
ziehen :: zog :: gezogen
zwingen :: zwang :: gezwungen
